11111111111
100CC000111
10011101111
111000000E1
1P001110011
11111111111