11111111
1P100E11
1C0010C1
11111111
